WWWWWWWWWWWWWWWWWWW
W0000000W000000000W
W0000000W000000000W
WWWWW0W0W0W0WWWWW0W
W000W0W000000000W0W
W000W0W000000000WWW
W0W0W0W0WWWW0WW000W
W0W000W0000W00W000W
00W000W0000W00W0W00
00WWW0WWWW0WW0W0W00
WWW000W0000W0000W0W
W00000W000000000W0W
W000W000WW0000W000W
W0WWW000000W00W000W
W0W000W0000WW0WWW0W
W0000000W0WW000000W
W000W000W0W0000000W
WWWWWWWWW0WWWWWWWWW