WWWWWWWWW0WWWWWWWWW
W000000000W0000000W
W000000000W0000000W
W0WWWWWWWWW0WWWWW0W
W0W0000000W00000W0W
W0W0000000W00000W0W
W000WWWWW0W0WWW0W0W
W000W00000W0W000WWW
W0W0W00000W0W000W00
WWW0W0WWW0W0W000W00
W000W0WWW0W0W000W0W
W000W0WWWWW0WWWWW0W
W0W0W0000000000000W
W0W0W0000000000000W
WWWWW0WWWWWWWWWWWWW
W00000000000000000W
W00000000000000000W
WWWWWWWWWWWWWWWWWWW
