WWWWWWWWWWWWWWWWWWW
W0W0000000W0000000W
W0W0000000W0000000W
W0W0WWWWW0W0WWWWW0W
W0W00000W0000000W0W
W0W00000W0000000W0W
W0WWWWW0W0WWWWW0W0W
W0000W00W00000W0W0W
W0000W00W0000000W00
W0WW0WWWW0WWW000W00
W00W000W0000W0W0W0W
W00W000W0000WWW000W
WW0W0W0W0WW0W00000W
W00W0W0000W00000WWW
W00W0WW000W000WWW0W
W00W0000W000W00000W
W00W0000W000W00000W
WWWWWWWWW0WWWWWWWWW